+++++++++++++++++++++++++++++++++++++++++++++++++++++++++++++++++++++++++++
+ .    +       +       +         +           +                        E +
+      +   .   +       +    +    +     +     +           +       +     +
+ +++++++     ++++++   +         +           +                   +     +
+   .      +        +       +    +     +           +     +       +     +
+   ++++   +   +    +    +       +           +           +             +
+        + +   +         +     . +     +           +           +       +
+    +     +   +    +    +    +  +           +     +     +             +
+          +        +            +                 +           +       +
+    + +   +   +    +    +       +     +           +                   +
+      +       +    +       +    +           +           +     +       +
+  T           +         +       +     +           +           +       +
+        +     +    +            +           +     +     +             +
+      +       +         +       +                 +           +       +
+    + +   +        +    +       +     +                 +             +
+      +       +    +       +          +           +           +       +
+              +         +       +           +           +     +       +
+        +          +            +                 +                   +
+      +       +    +       +    +           +           +     +       +
+++++++++++++++++++++++++++++++++++++++++++++++++++++++++++++++++++++++++++