+++++++++++++++++++++++++++++++++++++++++++++++++++++++++++++++++++
+     .           +                    +                        E +
+           +     +        .     +     +     +           +       +
+     +           +              +           +                   +
+           +     +        +           +     +     +     +       +
+     +           +              +                 +             +
+           +           .        +     +           +     +       +
+     +     +           +        +           +           +       +
+           +           +              +     +     +             +
+  T        +     +     +        +           +           +       +
+           +           +              +           +     +       +
+     +           +     +        +                 +             +
+           +           +              +     +           +       +
+     +     +     +           .        +           +     +       +
+           +           +              +                 +       +
+     +           +     +        +           +     +             +
+           +                          +           +     +       +
+     +     +     +     +        +                       +       +
+           +           +              +     +           +       +
+++++++++++++++++++++++++++++++++++++++++++++++++++++++++++++++++++