++++++++++++++++++++++++++++++++++++++++++++++++++++++++++++++++++++++++++++++++++++++
+               +               +               +               +               E +
+   +++++++   +   +++++++   +   +++++++   +   +++++++   +   +++++++   +   ++++++ +
+     .     +               +               +               +               +     +
+   +++++++   +++++++   +++++++   +++++++   +++++++   +++++++   +++++++   +++   +
+   +       +       +   +       +       +   +       +       +   +       +       +
+   +   +++++++   +   +   +++++++   +   +   +++++++   +   +   +++++++   +   +++ +
+       +               +               +       .       +               +       +
+   +++++++   +   +++++++   +   +++++++   +   +++++++   +   +++++++   +   +++++ +
+           +               +               +               +               +     +
+   +++++++   +++++++   +++++++   +++++++   +++++++   +++++++   +++++++   +++   +
+   +       +       +   +       +       +   +       +       +   +       +       +
+   +   +++++++   +   +   +++++++   +   +   +++++++   +   +   +++++++   +   +++ +
+       +               +               +               +               +   .   +
+   +++++++   +   +++++++   +   +++++++   +   +++++++   +   +++++++   +   +++++ +
+           +               +               +               +               +     +
+   +++++++   +++++++   +++++++   +++++++   +++++++   +++++++   +++++++   +++   +
+   +   .   +       +   +       +       +   +       +       +   +       +       +
+   +   +++++++   +   +   +++++++   +   +   +++++++   +   +   +++++++   +   +++ +
+       +               +               +               +               +       +
+   +++++++   +   +++++++   +   +++++++   +   +++++++   +   +++++++   +   +++++ +
+           +               +               +               +               +     +
+   +++++++   +++++++   +++++++   +++++++   +++++++   +++++++   +++++++   +++++ +
+ T                                                                             +
++++++++++++++++++++++++++++++++++++++++++++++++++++++++++++++++++++++++++++++++++++++