++++++++++++++++++++++++++++++++++++++++++++++++++++++++++++++++++++++++++++++++++++++
+                 +           +           +           +           +           E +
+   +   +   +   +   +   +   +   +   +   +   +   +   +   +   +   +   +   +   +   +
+       +       +   .   +       +       +       +       +       +       +       +
+   +   +   +   +   +   +   +   +   +   +   +   +   +   +   +   +   +   +   +   +
+               +               +               +               +               +
+   +   +   +   +   +   +   +   +   +   +   +   +   +   +   +   +   +   +   +   +
+       +       +       +       +       +       +       +       +       +       +
+   +   +   +   +   +   +   +   +   +   +   +   +   +   +   +   +   +   +   +   +
+               +               +       .       +               +               +
+   +   +   +   +   +   +   +   +   +   +   +   +   +   +   +   +   +   +   +   +
+               +               +               +               +               +
+   +   +   +   +   +   +   +   +   +   +   +   +   +   +   +   +   +   +   +   +
+       +       +       +       +       +       +       +   .   +       +       +
+   +   +   +   +   +   +   +   +   +   +   +   +   +   +   +   +   +   +   +   +
+               +               +               +               +               +
+   +   +   +   +   +   +   +   +   +   +   +   +   +   +   +   +   +   +   +   +
+       +       +       +       +       +       +       +       +       +   .   +
+   +   +   +   +   +   +   +   +   +   +   +   +   +   +   +   +   +   +   +   +
+                                                                             T +
++++++++++++++++++++++++++++++++++++++++++++++++++++++++++++++++++++++++++++++++++++++