++++++++++++++++++++++++++++++++++++++++++++++++++++++++++++++++++++++++++++++++++++++
+                   +                   +                   +                   E +
+       +       +       +       +   .   +       +       +       +       +       +
+               +               +               +               +               +
+   +       +       +       +       +       +       +       +       +       +   +
+               +               +               +               +               +
+   +       +       +       +       +       +       +       +       +       +   +
+               +               +               +       .       +               +
+   +       +       +       +       +       +       +       +       +       +   +
+               +               +               +               +               +
+   +       +       +       +       +       +       +       +       +       +   +
+               +               +               +               +               +
+   +       +       +       +       +       +       +       +       +       +   +
+               +               +   .   +               +               +       +
+   +       +       +       +       +       +       +       +       +       +   +
+               +               +               +               +               +
+   +       +       +       +       +       +       +       +       +   .   +   +
+               +               +               +               +               +
+   +       +       +       +       +       +       +       +       +       +   +
+                                                                             T +
++++++++++++++++++++++++++++++++++++++++++++++++++++++++++++++++++++++++++++++++++++++